"filename", "language", "JavaScript", "JSON", "HTML", "Properties", "CSS", "comment", "blank", "total"
"d:\Documents\2-2\CSE216\Pushti\.env", "Properties", 0, 0, 0, 4, 0, 0, 0, 4
"d:\Documents\2-2\CSE216\Pushti\controller\adminController\addLoan.js", "JavaScript", 59, 0, 0, 0, 0, 1, 5, 65
"d:\Documents\2-2\CSE216\Pushti\controller\adminController\addProduct.js", "JavaScript", 49, 0, 0, 0, 0, 0, 7, 56
"d:\Documents\2-2\CSE216\Pushti\controller\adminController\getAgentFeedback.js", "JavaScript", 137, 0, 0, 0, 0, 0, 8, 145
"d:\Documents\2-2\CSE216\Pushti\controller\adminController\getFarmerFeedback.js", "JavaScript", 137, 0, 0, 0, 0, 0, 8, 145
"d:\Documents\2-2\CSE216\Pushti\controller\adminController\getFarmerInfo.js", "JavaScript", 136, 0, 0, 0, 0, 0, 9, 145
"d:\Documents\2-2\CSE216\Pushti\controller\adminController\getReports.js", "JavaScript", 16, 0, 0, 0, 0, 0, 4, 20
"d:\Documents\2-2\CSE216\Pushti\controller\adminController\getReportsPost.js", "JavaScript", 60, 0, 0, 0, 0, 1, 7, 68
"d:\Documents\2-2\CSE216\Pushti\controller\adminController\upReport.js", "JavaScript", 46, 0, 0, 0, 0, 1, 7, 54
"d:\Documents\2-2\CSE216\Pushti\controller\adminController\upReportPage.js", "JavaScript", 11, 0, 0, 0, 0, 0, 4, 15
"d:\Documents\2-2\CSE216\Pushti\controller\adminController\updateAgent.js", "JavaScript", 99, 0, 0, 0, 0, 0, 5, 104
"d:\Documents\2-2\CSE216\Pushti\controller\adminController\updateBudget.js", "JavaScript", 89, 0, 0, 0, 0, 2, 7, 98
"d:\Documents\2-2\CSE216\Pushti\controller\adminController\updatePrice.js", "JavaScript", 126, 0, 0, 0, 0, 3, 8, 137
"d:\Documents\2-2\CSE216\Pushti\controller\adminController\updateTax.js", "JavaScript", 99, 0, 0, 0, 0, 0, 6, 105
"d:\Documents\2-2\CSE216\Pushti\controller\agentController.js", "JavaScript", 6, 0, 0, 0, 0, 7, 4, 17
"d:\Documents\2-2\CSE216\Pushti\controller\agentTransaction\agentBuyController.js", "JavaScript", 12, 0, 0, 0, 0, 1, 6, 19
"d:\Documents\2-2\CSE216\Pushti\controller\agentTransaction\agentSellController.js", "JavaScript", 11, 0, 0, 0, 0, 0, 5, 16
"d:\Documents\2-2\CSE216\Pushti\controller\agentTransaction\agentUpdatePhoto.js", "JavaScript", 90, 0, 0, 0, 0, 3, 8, 101
"d:\Documents\2-2\CSE216\Pushti\controller\agentTransaction\buyHistory.js", "JavaScript", 59, 0, 0, 0, 0, 0, 8, 67
"d:\Documents\2-2\CSE216\Pushti\controller\agentTransaction\executeBuy.js", "JavaScript", 185, 0, 0, 0, 0, 5, 18, 208
"d:\Documents\2-2\CSE216\Pushti\controller\agentTransaction\executeSell.js", "JavaScript", 73, 0, 0, 0, 0, 2, 7, 82
"d:\Documents\2-2\CSE216\Pushti\controller\agentTransaction\getBuyerInteractiveSell.js", "JavaScript", 47, 0, 0, 0, 0, 0, 7, 54
"d:\Documents\2-2\CSE216\Pushti\controller\agentTransaction\getFarmerInteractiveBuy.js", "JavaScript", 47, 0, 0, 0, 0, 0, 7, 54
"d:\Documents\2-2\CSE216\Pushti\controller\agentTransaction\getFarmerTypeProducts.js", "JavaScript", 63, 0, 0, 0, 0, 0, 7, 70
"d:\Documents\2-2\CSE216\Pushti\controller\agentTransaction\getInventoryStatus.js", "JavaScript", 53, 0, 0, 0, 0, 0, 8, 61
"d:\Documents\2-2\CSE216\Pushti\controller\agentTransaction\requestController.js", "JavaScript", 6, 0, 0, 0, 0, 1, 3, 10
"d:\Documents\2-2\CSE216\Pushti\controller\agentTransaction\requestUpdater.js", "JavaScript", 49, 0, 0, 0, 0, 0, 7, 56
"d:\Documents\2-2\CSE216\Pushti\controller\agentTransaction\sellHistory.js", "JavaScript", 59, 0, 0, 0, 0, 0, 8, 67
"d:\Documents\2-2\CSE216\Pushti\controller\agentTransaction\sendFeedbackAgent.js", "JavaScript", 68, 0, 0, 0, 0, 0, 10, 78
"d:\Documents\2-2\CSE216\Pushti\controller\agentTransaction\showAgentBuyPage.js", "JavaScript", 16, 0, 0, 0, 0, 0, 6, 22
"d:\Documents\2-2\CSE216\Pushti\controller\agentTransaction\showAgentSellPage.js", "JavaScript", 15, 0, 0, 0, 0, 0, 5, 20
"d:\Documents\2-2\CSE216\Pushti\controller\buyerInserter.js", "JavaScript", 60, 0, 0, 0, 0, 62, 12, 134
"d:\Documents\2-2\CSE216\Pushti\controller\buyerRegisterController.js", "JavaScript", 20, 0, 0, 0, 0, 1, 8, 29
"d:\Documents\2-2\CSE216\Pushti\controller\farmerController.js", "JavaScript", 10, 0, 0, 0, 0, 8, 5, 23
"d:\Documents\2-2\CSE216\Pushti\controller\farmer\farmerUpdateInfo.js", "JavaScript", 78, 0, 0, 0, 0, 60, 16, 154
"d:\Documents\2-2\CSE216\Pushti\controller\farmer\farmerUpdatePhoto.js", "JavaScript", 86, 0, 0, 0, 0, 3, 8, 97
"d:\Documents\2-2\CSE216\Pushti\controller\farmer\sendFeedbackFarmer.js", "JavaScript", 68, 0, 0, 0, 0, 0, 10, 78
"d:\Documents\2-2\CSE216\Pushti\controller\farmer\showFarmerTransactions.js", "JavaScript", 59, 0, 0, 0, 0, 0, 8, 67
"d:\Documents\2-2\CSE216\Pushti\controller\gatherAgentInfo.js", "JavaScript", 85, 0, 0, 0, 0, 1, 7, 93
"d:\Documents\2-2\CSE216\Pushti\controller\gatherFarmerInfo.js", "JavaScript", 81, 0, 0, 0, 0, 3, 6, 90
"d:\Documents\2-2\CSE216\Pushti\controller\getFarmerInfo.js", "JavaScript", 59, 0, 0, 0, 0, 12, 8, 79
"d:\Documents\2-2\CSE216\Pushti\controller\getLoanOptions.js", "JavaScript", 38, 0, 0, 0, 0, 0, 7, 45
"d:\Documents\2-2\CSE216\Pushti\controller\getLocationInfo.js", "JavaScript", 46, 0, 0, 0, 0, 1, 7, 54
"d:\Documents\2-2\CSE216\Pushti\controller\loginController.js", "JavaScript", 26, 0, 0, 0, 0, 5, 6, 37
"d:\Documents\2-2\CSE216\Pushti\controller\loginValidator.js", "JavaScript", 98, 0, 0, 0, 0, 51, 10, 159
"d:\Documents\2-2\CSE216\Pushti\controller\registerController.js", "JavaScript", 27, 0, 0, 0, 0, 5, 7, 39
"d:\Documents\2-2\CSE216\Pushti\controller\registerIsPendingRequest.js", "JavaScript", 61, 0, 0, 0, 0, 0, 9, 70
"d:\Documents\2-2\CSE216\Pushti\controller\registerValidator.js", "JavaScript", 57, 0, 0, 0, 0, 52, 10, 119
"d:\Documents\2-2\CSE216\Pushti\controller\requestInserter.js", "JavaScript", 84, 0, 0, 0, 0, 72, 19, 175
"d:\Documents\2-2\CSE216\Pushti\controller\requestShower.js", "JavaScript", 198, 0, 0, 0, 0, 0, 21, 219
"d:\Documents\2-2\CSE216\Pushti\index.js", "JavaScript", 47, 0, 0, 0, 0, 2, 7, 56
"d:\Documents\2-2\CSE216\Pushti\middlewares\buyerRegisterInputValidator.js", "JavaScript", 39, 0, 0, 0, 0, 15, 6, 60
"d:\Documents\2-2\CSE216\Pushti\middlewares\farmerChangePasswordValidator.js", "JavaScript", 27, 0, 0, 0, 0, 1, 4, 32
"d:\Documents\2-2\CSE216\Pushti\middlewares\isBuyerPresent.js", "JavaScript", 52, 0, 0, 0, 0, 0, 6, 58
"d:\Documents\2-2\CSE216\Pushti\middlewares\isBuyerValid.js", "JavaScript", 60, 0, 0, 0, 0, 0, 5, 65
"d:\Documents\2-2\CSE216\Pushti\middlewares\isFarmerValid.js", "JavaScript", 49, 0, 0, 0, 0, 0, 5, 54
"d:\Documents\2-2\CSE216\Pushti\middlewares\registerInputValidator.js", "JavaScript", 46, 0, 0, 0, 0, 15, 6, 67
"d:\Documents\2-2\CSE216\Pushti\package-lock.json", "JSON", 0, 3079, 0, 0, 0, 0, 1, 3080
"d:\Documents\2-2\CSE216\Pushti\package.json", "JSON", 0, 34, 0, 0, 0, 0, 1, 35
"d:\Documents\2-2\CSE216\Pushti\public\css\bootstrap.min.css", "CSS", 0, 0, 0, 0, 2, 10, 0, 12
"d:\Documents\2-2\CSE216\Pushti\public\css\styles.css", "CSS", 0, 0, 0, 0, 9525, 33, 1743, 11301
"d:\Documents\2-2\CSE216\Pushti\routes\adminRoute.js", "JavaScript", 67, 0, 0, 0, 0, 0, 4, 71
"d:\Documents\2-2\CSE216\Pushti\routes\agentRoute.js", "JavaScript", 24, 0, 0, 0, 0, 0, 4, 28
"d:\Documents\2-2\CSE216\Pushti\routes\farmerRoute.js", "JavaScript", 13, 0, 0, 0, 0, 0, 3, 16
"d:\Documents\2-2\CSE216\Pushti\routes\homePageRoute.js", "JavaScript", 8, 0, 0, 0, 0, 0, 4, 12
"d:\Documents\2-2\CSE216\Pushti\routes\loginRoute.js", "JavaScript", 5, 0, 0, 0, 0, 0, 2, 7
"d:\Documents\2-2\CSE216\Pushti\routes\logoutRoute.js", "JavaScript", 16, 0, 0, 0, 0, 0, 3, 19
"d:\Documents\2-2\CSE216\Pushti\routes\registerRoute.js", "JavaScript", 9, 0, 0, 0, 0, 0, 3, 12
"d:\Documents\2-2\CSE216\Pushti\views\HomeView.ejs", "HTML", 0, 0, 164, 0, 0, 45, 1, 210
"d:\Documents\2-2\CSE216\Pushti\views\adminAddLoan.ejs", "HTML", 0, 0, 256, 0, 0, 1, 6, 263
"d:\Documents\2-2\CSE216\Pushti\views\adminAddProduct.ejs", "HTML", 0, 0, 239, 0, 0, 1, 6, 246
"d:\Documents\2-2\CSE216\Pushti\views\adminCombinedReports.ejs", "HTML", 0, 0, 454, 0, 0, 2, 15, 471
"d:\Documents\2-2\CSE216\Pushti\views\adminDashboard.ejs", "HTML", 0, 0, 127, 0, 0, 1, 2, 130
"d:\Documents\2-2\CSE216\Pushti\views\adminFarmerInfo.ejs", "HTML", 0, 0, 423, 0, 0, 1, 18, 442
"d:\Documents\2-2\CSE216\Pushti\views\adminUpReport.ejs", "HTML", 0, 0, 335, 0, 0, 1, 13, 349
"d:\Documents\2-2\CSE216\Pushti\views\adminUpdateAgent.ejs", "HTML", 0, 0, 450, 0, 0, 1, 16, 467
"d:\Documents\2-2\CSE216\Pushti\views\adminUpdateBudget.ejs", "HTML", 0, 0, 383, 0, 0, 1, 14, 398
"d:\Documents\2-2\CSE216\Pushti\views\adminUpdatePrice.ejs", "HTML", 0, 0, 279, 0, 0, 1, 6, 286
"d:\Documents\2-2\CSE216\Pushti\views\adminUpdateTax.ejs", "HTML", 0, 0, 299, 0, 0, 1, 8, 308
"d:\Documents\2-2\CSE216\Pushti\views\agentBuyPage.ejs", "HTML", 0, 0, 416, 0, 0, 1, 18, 435
"d:\Documents\2-2\CSE216\Pushti\views\agentDashboard.ejs", "HTML", 0, 0, 255, 0, 0, 1, 6, 262
"d:\Documents\2-2\CSE216\Pushti\views\agentSellPage.ejs", "HTML", 0, 0, 408, 0, 0, 1, 17, 426
"d:\Documents\2-2\CSE216\Pushti\views\farmerDashboard.ejs", "HTML", 0, 0, 198, 0, 0, 1, 7, 206
"d:\Documents\2-2\CSE216\Pushti\views\farmerUpdateInfo.ejs", "HTML", 0, 0, 208, 0, 0, 1, 6, 215
"d:\Documents\2-2\CSE216\Pushti\views\inventoryStatus.ejs", "HTML", 0, 0, 141, 0, 0, 1, 5, 147
"d:\Documents\2-2\CSE216\Pushti\views\layout.ejs", "HTML", 0, 0, 32, 0, 0, 1, 1, 34
"d:\Documents\2-2\CSE216\Pushti\views\login.ejs", "HTML", 0, 0, 224, 0, 0, 2, 19, 245
"d:\Documents\2-2\CSE216\Pushti\views\register.ejs", "HTML", 0, 0, 657, 0, 0, 1, 37, 695
"d:\Documents\2-2\CSE216\Pushti\views\registerBuyer.ejs", "HTML", 0, 0, 422, 0, 0, 1, 19, 442
"d:\Documents\2-2\CSE216\Pushti\views\request.ejs", "HTML", 0, 0, 244, 0, 0, 1, 8, 253
"d:\Documents\2-2\CSE216\Pushti\views\sendFeedbackAgent.ejs", "HTML", 0, 0, 192, 0, 0, 1, 7, 200
"d:\Documents\2-2\CSE216\Pushti\views\sendFeedbackFarmer.ejs", "HTML", 0, 0, 170, 0, 0, 1, 7, 178
"d:\Documents\2-2\CSE216\Pushti\views\showAgentFeedback.ejs", "HTML", 0, 0, 209, 0, 0, 1, 6, 216
"d:\Documents\2-2\CSE216\Pushti\views\showBuyHistory.ejs", "HTML", 0, 0, 155, 0, 0, 1, 5, 161
"d:\Documents\2-2\CSE216\Pushti\views\showFarmerFeedback.ejs", "HTML", 0, 0, 210, 0, 0, 1, 6, 217
"d:\Documents\2-2\CSE216\Pushti\views\showFarmerTransactions.ejs", "HTML", 0, 0, 134, 0, 0, 1, 5, 140
"d:\Documents\2-2\CSE216\Pushti\views\showSellHistory.ejs", "HTML", 0, 0, 155, 0, 0, 1, 5, 161
"d:\Documents\2-2\CSE216\Pushti\views\temp.ejs", "HTML", 0, 0, 43, 0, 0, 1, 2, 46
"Total", "-", 3626, 3113, 7882, 4, 9527, 515, 2491, 27158